1113122311
1        1
1   211  1
1        4
1  133   1
4     1  5
1        1
1 31  11 1
1 1      1
1151133311