1113122311
1        1
1   211  1
2        4
1  133   1
4     1  4
1        3
1 31  11 1
1 1      3
1141133311